_id,report_date,previous_day_total_doses_administered,previous_day_at_least_one,previous_day_fully_vaccinated,previous_day_3doses,total_doses_administered,total_individuals_at_least_one,total_individuals_partially_vaccinated,total_doses_in_fully_vaccinated_individuals,total_individuals_fully_vaccinated,total_individuals_3doses
1,2021-01-01T00:00:00,6251,6241,2,,32189,32134,32123,22,11,
2,2021-01-02T00:00:00,4613,4601,6,,36802,36683,36670,26,13,
3,2021-01-03T00:00:00,5393,5386,3,,42195,42069,42053,32,16,
4,2021-01-04T00:00:00,5994,5992,0,,48189,48060,48045,30,15,
5,2021-01-05T00:00:00,9682,9657,20,,57871,57715,57681,68,34,
6,2021-01-06T00:00:00,12792,12327,450,,70663,70038,69558,960,480,
7,2021-01-07T00:00:00,16216,15505,697,,86879,85542,84365,2354,1177,
8,2021-01-08T00:00:00,18037,17022,1002,,104916,102564,100385,4358,2179,
9,2021-01-09T00:00:00,19500,18423,1064,,124416,120986,117743,6486,3243,
10,2021-01-10T00:00:00,11369,11330,37,,135785,132307,129028,6558,3279,
11,2021-01-11T00:00:00,11710,11661,48,,147495,143968,140641,6654,3327,
12,2021-01-12T00:00:00,14466,14159,298,,161961,158119,154494,7250,3625,
13,2021-01-13T00:00:00,15435,13813,1593,,177396,171918,166702,10432,5216,
14,2021-01-14T00:00:00,19182,16731,2436,,196578,188643,180992,15302,7651,
15,2021-01-15T00:00:00,20046,17990,2037,,216624,206622,196934,19376,9688,
16,2021-01-16T00:00:00,17115,15932,1170,,233739,222538,211680,21716,10858,
17,2021-01-17T00:00:00,11255,10012,1236,,244994,232535,220443,24184,12092,
18,2021-01-18T00:00:00,6792,6710,72,,251786,239222,227061,24322,12161,
19,2021-01-19T00:00:00,11825,9717,2094,,263611,248918,234663,28510,14255,
20,2021-01-20T00:00:00,10799,7210,3572,,274410,256105,238279,35652,17826,
21,2021-01-21T00:00:00,10968,6850,4091,,285378,262939,241022,43834,21917,
22,2021-01-22T00:00:00,9037,4320,4698,,294415,267222,240609,53226,26613,
23,2021-01-23T00:00:00,7447,3031,4388,,301862,270223,239223,62000,31000,
24,2021-01-24T00:00:00,4381,1825,2536,,306243,272030,238494,67072,33536,
25,2021-01-25T00:00:00,5318,1046,4263,,311561,273044,235246,75596,37798,
26,2021-01-26T00:00:00,9383,2860,6495,,320944,275872,231580,88584,44292,
27,2021-01-27T00:00:00,9893,2861,7004,,330837,278704,227409,102590,51295,
28,2021-01-28T00:00:00,13107,5732,7333,,343944,284403,225775,117256,58628,
29,2021-01-29T00:00:00,10684,3271,7379,,354628,287643,221637,132012,66006,
30,2021-01-30T00:00:00,9185,2726,6422,,363813,290327,217902,144850,72425,
31,2021-01-31T00:00:00,3373,1561,1767,,367186,291854,217663,148382,74191,
32,2021-02-01T00:00:00,2121,484,1609,,369307,292304,216508,151592,75796,
33,2021-02-02T00:00:00,4405,1352,2995,,373712,293618,214831,157574,78787,
34,2021-02-03T00:00:00,6232,1712,4458,,379944,295289,212051,166476,83238,
35,2021-02-04T00:00:00,9076,1707,7290,,389020,296953,206431,181044,90522,
36,2021-02-05T00:00:00,8439,1465,6903,,397459,298378,200959,194838,97419,
37,2021-02-06T00:00:00,10657,1862,8736,,408116,300185,194039,212292,106146,
38,2021-02-07T00:00:00,7569,1725,5796,,415685,301870,189940,223860,111930,
39,2021-02-08T00:00:00,8216,3094,5080,,423901,304916,187919,233994,116997,
40,2021-02-09T00:00:00,14997,3851,11080,,438898,308725,180664,256122,128061,
41,2021-02-10T00:00:00,15502,4924,10518,,454400,313597,175043,277108,138554,
42,2021-02-11T00:00:00,16359,3896,12407,,470759,317441,166511,301860,150930,
43,2021-02-12T00:00:00,17649,2094,15505,,488408,319497,153081,332832,166416,
44,2021-02-13T00:00:00,16200,2438,13746,,504608,321890,141747,360286,180143,
45,2021-02-14T00:00:00,12876,919,11925,,517484,322761,130723,384076,192038,
46,2021-02-15T00:00:00,7859,483,7328,,525343,323196,123856,398680,199340,
47,2021-02-16T00:00:00,5990,1040,4900,,531333,324193,119976,408434,204217,
48,2021-02-17T00:00:00,10160,1604,8522,,541493,325753,113042,425422,212711,
49,2021-02-18T00:00:00,13866,2952,10870,,555359,328657,105106,447102,223551,
50,2021-02-19T00:00:00,18486,6212,12207,,573845,334817,99090,471454,235727,
51,2021-02-20T00:00:00,22621,11129,11440,,596466,345883,98754,494258,247129,
52,2021-02-21T00:00:00,17232,10377,6821,,613698,356200,102292,507816,253908,
53,2021-02-22T00:00:00,13576,8750,4775,,627274,364880,106247,517266,258633,
54,2021-02-23T00:00:00,17855,11119,6665,,645129,375943,110681,530524,265262,
55,2021-02-24T00:00:00,18565,13605,4879,,663694,389492,119393,540198,270099,
56,2021-02-25T00:00:00,20801,16485,4259,,684495,405911,131601,548620,274310,
57,2021-02-26T00:00:00,24881,21826,2995,,709376,427677,150409,554536,277268,
58,2021-02-27T00:00:00,27449,23573,3835,,736825,451186,170131,562110,281055,
59,2021-02-28T00:00:00,20578,19139,1405,,757403,470271,187853,564836,282418,
60,2021-03-01T00:00:00,18216,17022,1148,,775619,487231,203712,567038,283519,
61,2021-03-02T00:00:00,24671,22268,2319,,800290,509438,223646,571584,285792,
62,2021-03-03T00:00:00,30586,27957,2576,,830876,537344,249009,576670,288335,
63,2021-03-04T00:00:00,34680,32453,2142,,865556,569731,279304,580854,290427,
64,2021-03-05T00:00:00,39980,38151,1781,,905536,607834,315660,584348,292174,
65,2021-03-06T00:00:00,44134,41932,2164,,949670,649711,355414,588594,294297,
66,2021-03-07T00:00:00,32726,31548,1174,,982396,681185,385772,590826,295413,
67,2021-03-08T00:00:00,24035,22161,1861,,1006431,703278,406058,594440,297220,
68,2021-03-09T00:00:00,33278,29831,3419,,1039709,733043,432450,601186,300593,
69,2021-03-10T00:00:00,38322,34063,4214,,1078031,767032,462273,609518,304759,
70,2021-03-11T00:00:00,43964,40693,3232,,1121995,807659,499720,615878,307939,
71,2021-03-12T00:00:00,47694,45982,1688,,1169689,853577,544000,619154,309577,
72,2021-03-13T00:00:00,57897,55026,2843,,1227586,908532,596166,624732,312366,
73,2021-03-14T00:00:00,43395,42161,1217,,1270981,950610,637095,627030,313515,
74,2021-03-15T00:00:00,32796,31100,1681,,1303777,981651,666498,630306,315153,
75,2021-03-16T00:00:00,53936,51644,2276,,1357713,1033230,715844,634772,317386,
76,2021-03-17T00:00:00,61051,58515,2493,,1418764,1091679,771850,639658,319829,
77,2021-03-18T00:00:00,61523,59070,2428,,1480287,1150677,828473,644408,322204,
78,2021-03-19T00:00:00,64450,61129,3268,,1544737,1211728,886309,650838,325419,
79,2021-03-20T00:00:00,62552,59966,2555,,1607289,1271638,943712,655852,327926,
80,2021-03-21T00:00:00,43984,42465,1533,,1651273,1314038,984616,658844,329422,
81,2021-03-22T00:00:00,30989,30027,973,,1682262,1343977,1013638,660678,330339,
82,2021-03-23T00:00:00,54601,51828,2723,,1736863,1395710,1062711,665998,332999,
83,2021-03-24T00:00:00,76410,73229,3133,,1813273,1468849,1132774,672150,336075,
84,2021-03-25T00:00:00,82897,80318,2532,,1896170,1549088,1210538,677100,338550,
85,2021-03-26T00:00:00,86986,83457,3490,,1983156,1632464,1290476,683976,341988,
86,2021-03-27T00:00:00,80834,77887,2863,,2063990,1710248,1365462,689572,344786,
87,2021-03-28T00:00:00,66980,65394,1553,,2130970,1775552,1429270,692564,346282,
88,2021-03-29T00:00:00,51726,49040,2651,,2182696,1824512,1475625,697774,348887,
89,2021-03-30T00:00:00,73561,70155,3348,,2256257,1894590,1542396,704388,352194,
90,2021-03-31T00:00:00,93138,89494,3577,,2349395,1983986,1628268,711436,355718,
91,2021-04-01T00:00:00,89296,85425,3833,,2438691,2069313,1709815,718996,359498,
92,2021-04-02T00:00:00,93067,88844,4207,,2531758,2158071,1794418,727306,363653,
93,2021-04-03T00:00:00,60989,59317,1730,,2592747,2217297,1851965,730664,365332,
94,2021-04-04T00:00:00,72323,70673,1646,,2665070,2287859,1920939,733840,366920,
95,2021-04-05T00:00:00,53725,53256,469,,2718795,2341031,1973690,734682,367341,
96,2021-04-06T00:00:00,79569,77706,1883,,2798364,2418636,2049465,738342,369171,
97,2021-04-07T00:00:00,107992,104932,3052,,2906356,2523443,2151278,744330,372165,
98,2021-04-08T00:00:00,114060,110097,4020,,3020416,2633429,2257300,752258,376129,
99,2021-04-09T00:00:00,109825,105609,4290,,3130241,2738920,2358566,760708,380354,
100,2021-04-10T00:00:00,109218,105468,3843,,3239459,2844260,2460129,768262,384131,
101,2021-04-11T00:00:00,98610,95499,3255,,3338069,2939634,2552307,774654,387327,
102,2021-04-12T00:00:00,76058,74997,1154,,3414127,3014483,2626070,776826,388413,
103,2021-04-13T00:00:00,99455,96080,3395,,3513582,3110454,2718694,783520,391760,
104,2021-04-14T00:00:00,117030,113272,3647,,3630612,3223608,2828241,790734,395367,
105,2021-04-15T00:00:00,113548,109496,3894,,3744160,3332978,2933774,798408,399204,
106,2021-04-16T00:00:00,118086,113718,4190,,3862246,3446586,3043236,806700,403350,
107,2021-04-17T00:00:00,112400,107817,4444,,3974646,3554269,3146534,815470,407735,
108,2021-04-18T00:00:00,88731,86499,2100,,4063377,3640645,3230864,819562,409781,
109,2021-04-19T00:00:00,68959,67433,1447,,4132336,3707948,3296771,822354,411177,
110,2021-04-20T00:00:00,101905,98587,3114,,4234241,3806373,3392147,828452,414226,
111,2021-04-21T00:00:00,141980,137716,4030,,4376221,3943915,3525727,836376,418188,
112,2021-04-22T00:00:00,139459,135320,3901,,4515680,4079106,3657073,844066,422033,
113,2021-04-23T00:00:00,138187,131786,6156,,4653867,4210738,3782607,856262,428131,
114,2021-04-24T00:00:00,130269,126217,3881,,4784136,4336807,3904851,863912,431956,
115,2021-04-25T00:00:00,102004,98601,3175,,4886140,4435260,4000196,870128,435064,
116,2021-04-26T00:00:00,70996,69294,1555,,4957136,4504423,4067864,873118,436559,
117,2021-04-27T00:00:00,98484,95412,2883,,5055620,4599674,4160295,878758,439379,
118,2021-04-28T00:00:00,120557,115943,4424,,5176177,4715449,4271718,887462,443731,
119,2021-04-29T00:00:00,124463,119275,5043,,5300640,4834557,4385852,897410,448705,
120,2021-04-30T00:00:00,115796,110554,5007,,5416436,4944938,4491303,907270,453635,
121,2021-05-01T00:00:00,111271,107419,3637,,5527707,5052176,4594981,914390,457195,
122,2021-05-02T00:00:00,79126,76155,2859,,5606833,5128174,4668186,919976,459988,
123,2021-05-03T00:00:00,56781,55116,1593,,5663614,5183135,4721614,923042,461521,
124,2021-05-04T00:00:00,91914,88547,3281,,5755528,5271504,4806779,929450,464725,
125,2021-05-05T00:00:00,137977,133279,4614,,5893505,5404614,4935338,938552,469276,
126,2021-05-06T00:00:00,141825,136873,4815,,6035330,5541303,5067274,948058,474029,
127,2021-05-07T00:00:00,150257,145228,4830,,6185587,5686371,5207571,957600,478800,
128,2021-05-08T00:00:00,142438,137759,4431,,6328025,5823935,5340783,966304,483152,
129,2021-05-09T00:00:00,124786,121143,3476,,6452811,5944914,5458350,973128,486564,
130,2021-05-10T00:00:00,97792,95817,1875,,6550603,6040542,5552170,976744,488372,
131,2021-05-11T00:00:00,113502,108841,4484,,6664105,6149181,5656396,985570,492785,
132,2021-05-12T00:00:00,145021,138003,6872,,6809126,6287005,5787414,999182,499591,
133,2021-05-13T00:00:00,142648,135300,7201,,6951774,6422130,5915412,1013436,506718,
134,2021-05-14T00:00:00,148852,138758,9926,,7100626,6560700,6044121,1033158,516579,
135,2021-05-15T00:00:00,159703,149671,9855,,7260329,6710184,6183825,1052718,526359,
136,2021-05-16T00:00:00,144341,136077,8060,,7404670,6846093,6311754,1068678,534339,
137,2021-05-17T00:00:00,114960,110865,3942,,7519630,6956769,6418564,1076410,538205,
138,2021-05-18T00:00:00,111295,100440,10655,,7630925,7057013,6508215,1097596,548798,
139,2021-05-19T00:00:00,149853,133453,16224,,7780778,7190314,6625366,1129896,564948,
140,2021-05-20T00:00:00,151537,131556,19769,,7932315,7321681,6737033,1169296,584648,
141,2021-05-21T00:00:00,165355,140859,24240,,8097670,7462359,6853548,1217622,608811,
142,2021-05-22T00:00:00,199401,172220,26955,,8297071,7634382,6998697,1271370,635685,
143,2021-05-23T00:00:00,139806,127440,12222,,8436877,7761644,7113799,1295690,647845,
144,2021-05-24T00:00:00,100281,93311,6825,,8537158,7854782,7200182,1309200,654600,
145,2021-05-25T00:00:00,90437,82958,7271,,8627595,7937577,7275773,1323608,661804,
146,2021-05-26T00:00:00,139747,112985,26498,,8767342,8050375,7362143,1376464,688232,
147,2021-05-27T00:00:00,152042,123024,28765,,8919384,8173242,7456314,1433856,716928,
148,2021-05-28T00:00:00,163839,132288,31245,,9083223,8305357,7557243,1496228,748114,
149,2021-05-29T00:00:00,153354,117101,36021,,9236577,8422309,7638230,1568158,784079,
150,2021-05-30T00:00:00,149702,119004,30474,,9386279,8541143,7726652,1628982,814491,
151,2021-05-31T00:00:00,99196,79803,19202,,9485475,8620776,7787147,1667258,833629,
152,2021-06-01T00:00:00,124164,90591,33239,,9609639,8711172,7844379,1733586,866793,
153,2021-06-02T00:00:00,145279,102126,42905,,9754918,8813117,7903488,1819258,909629,
154,2021-06-03T00:00:00,155331,99889,55164,,9910249,8912822,7948100,1929444,964722,
155,2021-06-04T00:00:00,181686,115513,65903,,10091935,9028136,7997599,2061074,1030537,
156,2021-06-05T00:00:00,171985,103409,68301,,10263920,9131347,8032594,2197506,1098753,
157,2021-06-06T00:00:00,163363,91844,71239,,10427283,9223013,8053091,2339844,1169922,
158,2021-06-07T00:00:00,119549,63042,56290,,10546832,9285858,8059721,2452274,1226137,
159,2021-06-08T00:00:00,161876,72437,89001,,10708708,9358106,8043048,2630116,1315058,
160,2021-06-09T00:00:00,181441,70791,110185,,10890149,9428720,8003558,2850324,1425162,
161,2021-06-10T00:00:00,185553,66408,118658,,11075702,9494925,7951196,3087458,1543729,
162,2021-06-11T00:00:00,204755,67498,136505,,11280457,9562237,7882085,3360304,1680152,
163,2021-06-12T00:00:00,199699,62657,136445,,11480156,9624712,7808207,3633010,1816505,
164,2021-06-13T00:00:00,190302,58863,130913,,11670458,9683400,7736062,3894676,1947338,
165,2021-06-14T00:00:00,137672,38685,98593,,11808130,9721889,7676063,4091652,2045826,
166,2021-06-15T00:00:00,189187,42587,146250,,11997317,9764258,7572279,4383958,2191979,
167,2021-06-16T00:00:00,206103,42419,163044,,12203420,9806481,7451561,4709840,2354920,
168,2021-06-17T00:00:00,210385,37921,171886,,12413805,9844187,7317473,5053428,2526714,
169,2021-06-18T00:00:00,217123,35342,181180,,12630928,9879339,7171537,5415604,2707802,
170,2021-06-19T00:00:00,215839,35478,179693,,12846767,9914611,7027228,5774766,2887383,
171,2021-06-20T00:00:00,186241,35547,150118,,13033008,9949960,6912567,6074786,3037393,
172,2021-06-21T00:00:00,120417,20819,99099,,13153425,9970584,6834184,6272800,3136400,
173,2021-06-22T00:00:00,204901,27493,176657,,13358326,9997883,6684935,6625896,3312948,
174,2021-06-23T00:00:00,230495,28614,201146,,13588821,10026297,6512311,7027972,3513986,
175,2021-06-24T00:00:00,227658,26662,200248,,13816479,10052763,6338639,7428248,3714124,
176,2021-06-25T00:00:00,251078,27963,222371,,14067557,10080525,6144148,7872754,3936377,
177,2021-06-26T00:00:00,261261,29993,230567,,14328818,10110293,5943489,8333608,4166804,
178,2021-06-27T00:00:00,204978,27777,176598,,14533796,10137888,5794596,8686584,4343292,
179,2021-06-28T00:00:00,199233,20950,177724,,14733029,10158640,5637749,9041782,4520891,
180,2021-06-29T00:00:00,250091,24484,224880,,14983120,10182883,5437266,9491234,4745617,
181,2021-06-30T00:00:00,275510,24165,250780,,15258630,10206845,5210577,9992536,4996268,
182,2021-07-01T00:00:00,271951,25297,246102,,15530581,10231924,4989693,10484462,5242231,
183,2021-07-02T00:00:00,144706,11580,132902,,15675287,10243330,4868299,10750062,5375031,
184,2021-07-03T00:00:00,216878,19922,196724,,15892165,10263030,4691424,11143212,5571606,
185,2021-07-04T00:00:00,196142,19398,176522,,16088307,10282242,4534233,11496018,5748009,
186,2021-07-05T00:00:00,148708,12435,136130,,16237015,10294488,4410476,11768024,5884012,
187,2021-07-06T00:00:00,220006,19981,199810,,16457021,10314253,4230577,12167352,6083676,
188,2021-07-07T00:00:00,246594,22962,223393,,16703615,10336989,4030068,12613842,6306921,
189,2021-07-08T00:00:00,231179,21342,209628,,16934794,10358125,3841711,13032828,6516414,
190,2021-07-09T00:00:00,226970,21498,205306,,17161764,10379421,3657833,13443176,6721588,
191,2021-07-10T00:00:00,209046,20533,188359,,17370810,10399750,3489940,13819620,6909810,
192,2021-07-11T00:00:00,171651,17565,153961,,17542461,10417114,3353490,14127248,7063624,
193,2021-07-12T00:00:00,123118,11441,111580,,17665579,10428366,3253299,14350134,7175067,
194,2021-07-13T00:00:00,178465,19016,159307,,17844044,10447160,3112941,14668438,7334219,
195,2021-07-14T00:00:00,180015,19294,160565,,18024059,10466239,2971618,14989242,7494621,
196,2021-07-15T00:00:00,167172,19578,147422,,18191231,10485606,2843727,15283758,7641879,
197,2021-07-16T00:00:00,169320,19887,149281,,18360551,10505291,2714284,15582014,7791007,
198,2021-07-17T00:00:00,172978,20253,152600,,18533529,10525295,2581880,15886830,7943415,
199,2021-07-18T00:00:00,133612,15921,117552,,18667141,10541032,2480213,16121638,8060819,
200,2021-07-19T00:00:00,91963,10411,81445,,18759104,10551230,2409141,16284178,8142089,
201,2021-07-20T00:00:00,133516,16937,116521,,18892620,10567927,2309493,16516868,8258434,
202,2021-07-21T00:00:00,140069,16977,123021,,19032689,10584689,2203396,16762586,8381293,
203,2021-07-22T00:00:00,125576,17628,107814,,19158265,10602093,2113163,16977860,8488930,
204,2021-07-23T00:00:00,120241,16980,103055,,19278506,10618832,2027046,17183572,8591786,
205,2021-07-24T00:00:00,126670,18324,108109,,19405176,10636953,1937221,17399464,8699732,
206,2021-07-25T00:00:00,103614,14852,88634,,19508790,10651581,1863396,17576370,8788185,
207,2021-07-26T00:00:00,66673,9880,56702,,19575463,10661243,1816537,17689412,8844706,
208,2021-07-27T00:00:00,92354,15311,76882,,19667817,10676293,1754922,17842742,8921371,
209,2021-07-28T00:00:00,93910,16444,77390,,19761727,10692502,1693932,17997140,8998570,
210,2021-07-29T00:00:00,89372,16693,72516,,19851099,10708963,1638065,18141796,9070898,
211,2021-07-30T00:00:00,84030,16088,67829,,19935129,10724823,1586284,18277078,9138539,
212,2021-07-31T00:00:00,83819,15696,67970,,20018948,10740301,1533982,18412638,9206319,
213,2021-08-01T00:00:00,61849,11308,50360,,20080797,10751383,1494895,18512976,9256488,
214,2021-08-02T00:00:00,42464,7400,34946,,20123261,10758585,1467317,18582536,9291268,
215,2021-08-03T00:00:00,33268,5945,27155,,20156529,10764297,1446084,18636426,9318213,
216,2021-08-04T00:00:00,61294,12363,48740,,20217823,10776425,1409670,18733510,9366755,
217,2021-08-05T00:00:00,59421,12524,46743,,20277244,10788741,1375407,18826668,9413334,
218,2021-08-06T00:00:00,55996,11846,43935,,20333240,10800327,1343287,18914080,9457040,
219,2021-08-07T00:00:00,62343,12118,50029,,20395583,10812184,1305333,19013702,9506851,
220,2021-08-08T00:00:00,48646,9248,39211,,20444229,10821204,1275347,19091714,9545857,
221,2021-08-09T00:00:00,30838,5929,24736,,20475067,10826919,1256513,19140812,9570406,
222,2021-08-10T00:00:00,49226,10494,38433,,20524293,10837133,1228540,19217186,9608593,
223,2021-08-11T00:00:00,48698,10757,37700,,20572991,10847643,1201566,19292154,9646077,
224,2021-08-12T00:00:00,49214,11179,37809,,20622205,10858571,1174894,19367354,9683677,
225,2021-08-13T00:00:00,49595,11717,37604,,20671800,10870047,1148977,19442140,9721070,
226,2021-08-14T00:00:00,51189,12122,38859,,20722989,10881919,1122214,19519410,9759705,
227,2021-08-15T00:00:00,41737,9840,31676,,20764726,10891557,1100348,19582418,9791209,
228,2021-08-16T00:00:00,26717,6171,20391,,20791443,10897505,1086102,19622806,9811403,
229,2021-08-17T00:00:00,40476,11044,29170,,20831919,10908299,1067952,19680694,9840347,
230,2021-08-18T00:00:00,41874,11959,29675,,20873793,10920016,1050204,19739624,9869812,
231,2021-08-19T00:00:00,45864,16515,29087,,20919657,10936280,1037604,19797352,9898676,
232,2021-08-20T00:00:00,46407,16269,29724,,20966064,10952293,1024122,19856342,9928171,
233,2021-08-21T00:00:00,47928,15136,32423,,21013992,10967169,1006802,19920734,9960367,
234,2021-08-22T00:00:00,34370,10799,23304,,21048362,10977722,994273,19966898,9983449,
235,2021-08-23T00:00:00,23214,7002,15996,,21071576,10984489,985258,19998462,9999231,
236,2021-08-24T00:00:00,37629,13360,23813,,21109205,10997595,974782,20045626,10022813,
237,2021-08-25T00:00:00,41305,14400,26300,,21150510,11011739,962863,20097752,10048876,
238,2021-08-26T00:00:00,39245,13548,24955,,21189755,11025011,951421,20147180,10073590,
239,2021-08-27T00:00:00,37642,12922,23677,,21227397,11037692,940639,20194106,10097053,
240,2021-08-28T00:00:00,40083,13408,25501,,21267480,11050822,928522,20244600,10122300,
241,2021-08-29T00:00:00,30521,10234,19932,,21298001,11060824,918805,20284038,10142019,
242,2021-08-30T00:00:00,18225,6136,11840,,21316226,11066712,913072,20307280,10153640,
243,2021-08-31T00:00:00,32692,11930,19613,,21348918,11078374,905361,20346026,10173013,
244,2021-09-01T00:00:00,36215,12933,21938,,21385133,11091074,896340,20389468,10194734,
245,2021-09-02T00:00:00,37744,15634,19650,,21422877,11106456,892299,20428314,10214157,
246,2021-09-03T00:00:00,46837,21066,22423,,21469714,11127274,890923,20472702,10236351,
247,2021-09-04T00:00:00,46855,20580,24764,,21516569,11147608,886716,20521784,10260892,
248,2021-09-05T00:00:00,33051,14198,18567,,21549620,11161562,882327,20558470,10279235,
249,2021-09-06T00:00:00,21692,9479,12026,,21571312,11170792,879763,20582058,10291029,
250,2021-09-07T00:00:00,14976,6715,8079,,21586288,11177250,878382,20597736,10298868,
251,2021-09-08T00:00:00,41118,17101,20924,,21627406,11194087,874541,20639092,10319546,
252,2021-09-09T00:00:00,41426,16965,19665,,21668832,11210775,871816,20677918,10338959,
253,2021-09-10T00:00:00,39611,15498,18980,,21708443,11226011,868316,20715390,10357695,
254,2021-09-11T00:00:00,42349,15926,23323,,21750792,11241658,860898,20761520,10380760,
255,2021-09-12T00:00:00,29948,11528,17859,,21780740,11252892,854537,20796710,10398355,
256,2021-09-13T00:00:00,16066,6398,9172,,21796806,11259056,851748,20814616,10407308,
257,2021-09-14T00:00:00,29886,11552,15281,,21826692,11270307,847992,20844630,10422315,
258,2021-09-15T00:00:00,39256,14014,19411,,21865948,11284062,842580,20882964,10441482,
259,2021-09-16T00:00:00,39327,13974,19238,,21905275,11297801,837293,20921016,10460508,
260,2021-09-17T00:00:00,38899,13598,19323,,21944174,11311156,831556,20959200,10479600,
261,2021-09-18T00:00:00,41201,14074,23505,,21985375,11324957,822104,21005706,10502853,
262,2021-09-19T00:00:00,30639,10822,18972,,22016014,11335520,813941,21043158,10521579,
263,2021-09-20T00:00:00,16724,6098,10173,,22032738,11341364,809843,21063042,10531521,
264,2021-09-21T00:00:00,31339,11208,16979,,22064077,11352307,804056,21096502,10548251,
265,2021-09-22T00:00:00,41793,14812,22915,,22105870,11366823,795932,21141782,10570891,
266,2021-09-23T00:00:00,47202,16130,26016,,22153072,11382690,786027,21193326,10596663,
267,2021-09-24T00:00:00,46280,15627,26635,,22199352,11398056,775000,21246112,10623056,
268,2021-09-25T00:00:00,48170,15246,29933,,22247522,11413049,760294,21305510,10652755,
269,2021-09-26T00:00:00,37478,12414,24473,,22285000,11425188,748214,21353948,10676974,
270,2021-09-27T00:00:00,19145,6527,12312,,22304145,11431461,742413,21378096,10689048,
271,2021-09-28T00:00:00,30932,11286,17865,,22335077,11442488,735822,21413332,10706666,
272,2021-09-29T00:00:00,37861,12468,21711,,22372938,11454685,726559,21456252,10728126,
273,2021-09-30T00:00:00,37315,11647,21360,,22410253,11466073,716827,21498492,10749246,
274,2021-10-01T00:00:00,30855,9804,18400,,22441108,11475651,708218,21534866,10767433,
275,2021-10-02T00:00:00,37114,11151,23572,,22478222,11486532,695779,21581506,10790753,
276,2021-10-03T00:00:00,27198,8161,18321,,22505420,11494452,685606,21617692,10808846,
277,2021-10-04T00:00:00,14864,4744,9801,,22520284,11498950,680531,21636838,10818419,
278,2021-10-05T00:00:00,26794,8584,15854,,22547078,11507273,673246,21668054,10834027,
279,2021-10-06T00:00:00,31642,9634,18494,,22578720,11516648,664378,21704540,10852270,
280,2021-10-07T00:00:00,30331,9388,17112,,22609051,11525785,656641,21738288,10869144,
281,2021-10-08T00:00:00,32816,10736,18839,,22641867,11536251,648525,21775452,10887726,
282,2021-10-09T00:00:00,34116,10652,21004,,22675983,11546640,638159,21816962,10908481,
283,2021-10-10T00:00:00,23393,7654,15075,,22699376,11554043,630726,21846634,10923317,
284,2021-10-11T00:00:00,11997,3837,7862,,22711373,11557630,626685,21861890,10930945,
285,2021-10-12T00:00:00,5094,1623,3257,,22716467,11558975,625036,21867878,10933939,
286,2021-10-13T00:00:00,29089,9188,18073,,22745556,11567873,616135,21903476,10951738,
287,2021-10-14T00:00:00,28996,8900,17738,,22774552,11576498,607287,21938422,10969211,
288,2021-10-15T00:00:00,29072,8819,18157,,22803624,11585054,597936,21974236,10987118,
289,2021-10-16T00:00:00,31127,8982,19865,,22834751,11593745,587041,22013408,11006704,
290,2021-10-17T00:00:00,23691,7256,15365,,22858442,11600747,578919,22043656,11021828,
291,2021-10-18T00:00:00,12301,3747,8144,,22870743,11604213,574510,22059406,11029703,
292,2021-10-19T00:00:00,21249,6619,12620,,22891992,11610550,568496,22084108,11042054,
293,2021-10-20T00:00:00,25633,7536,14900,,22917625,11617839,561119,22113440,11056720,
294,2021-10-21T00:00:00,23154,6674,13021,,22940779,11624244,554761,22138966,11069483,
295,2021-10-22T00:00:00,26096,7305,15098,,22966875,11631227,546952,22168550,11084275,
296,2021-10-23T00:00:00,28162,7600,17147,,22995037,11638565,537398,22202334,11101167,
297,2021-10-24T00:00:00,19339,5727,12592,,23014376,11644036,530521,22227030,11113515,
298,2021-10-25T00:00:00,9922,2710,6473,,23024298,11646477,526750,22239454,11119727,
299,2021-10-26T00:00:00,18889,5386,11088,,23043187,11651585,521039,22261092,11130546,
300,2021-10-27T00:00:00,22832,6072,13200,,23066019,11657402,513897,22287010,11143505,
301,2021-10-28T00:00:00,22289,5791,12634,,23088308,11662905,507043,22311724,11155862,
302,2021-10-29T00:00:00,22795,5728,13039,,23111103,11668332,499718,22337228,11168614,
303,2021-10-30T00:00:00,24085,6033,14598,,23135188,11674093,491141,22365904,11182952,
304,2021-10-31T00:00:00,16464,4593,10589,,23151652,11678392,485140,22386504,11193252,
305,2021-11-01T00:00:00,7863,2079,5052,,23159515,11680191,482154,22396074,11198037,
306,2021-11-02T00:00:00,15613,4362,7737,,23175128,11684262,478768,22410988,11205494,
307,2021-11-03T00:00:00,18605,5065,9597,,23193733,11689024,474226,22429596,11214798,
308,2021-11-04T00:00:00,19484,4867,10020,,23213217,11693615,469058,22449114,11224557,
309,2021-11-05T00:00:00,21443,4396,9512,,23234660,11697722,463928,22467588,11233794,
310,2021-11-06T00:00:00,25316,5200,12149,,23259976,11702653,456962,22491382,11245691,
311,2021-11-07T00:00:00,21432,4021,8910,,23281408,11706394,452061,22508666,11254333,
312,2021-11-08T00:00:00,11988,2110,4729,,23293396,11708209,449426,22517566,11258783,
313,2021-11-09T00:00:00,24102,3846,7635,,23317498,11711734,445627,22532214,11266107,
314,2021-11-10T00:00:00,28456,4504,8983,,23345954,11715960,441134,22549652,11274826,
315,2021-11-11T00:00:00,28739,4300,9086,,23374693,11719964,436339,22567250,11283625,
316,2021-11-12T00:00:00,26720,4161,8218,,23401413,11723834,432268,22583132,11291566,
317,2021-11-13T00:00:00,34288,5076,11398,,23435701,11728604,425937,22605334,11302667,
318,2021-11-14T00:00:00,23209,3898,8597,,23458910,11732239,421231,22622016,11311008,
319,2021-11-15T00:00:00,12695,2185,4490,,23471605,11734164,418918,22630492,11315246,
320,2021-11-16T00:00:00,26156,3926,7469,,23497761,11737833,415371,22644924,11322462,
321,2021-11-17T00:00:00,31143,4046,7797,,23528904,11741597,411610,22659974,11329987,
322,2021-11-18T00:00:00,32471,3855,7507,,23561375,11745146,407944,22674404,11337202,
323,2021-11-19T00:00:00,35445,3857,7740,,23596820,11748703,404049,22689308,11344654,
324,2021-11-20T00:00:00,40098,4379,8807,,23636918,11752803,399612,22706382,11353191,
325,2021-11-21T00:00:00,28104,3432,6941,,23665022,11755973,396089,22719768,11359884,
326,2021-11-22T00:00:00,14890,1949,3890,,23679912,11757646,394142,22727008,11363504,
327,2021-11-23T00:00:00,33041,3271,6002,,23712953,11760637,391403,22738468,11369234,
328,2021-11-24T00:00:00,42626,3751,6790,,23755579,11764084,388353,22751462,11375731,
329,2021-11-25T00:00:00,46020,3931,6557,,23801599,11767740,385724,22764032,11382016,
330,2021-11-26T00:00:00,52817,11342,6606,,23854416,11778812,390453,22776718,11388359,
331,2021-11-27T00:00:00,63493,22350,7023,,23917909,11800881,405770,22790222,11395111,
332,2021-11-28T00:00:00,51447,27738,5308,,23969356,11828327,428188,22800278,11400139,
333,2021-11-29T00:00:00,33517,18932,2876,,24002873,11846998,444233,22805530,11402765,
334,2021-11-30T00:00:00,55997,20669,5120,,24058870,11867386,459772,22815228,11407614,
335,2021-12-01T00:00:00,69519,26235,5625,,24128389,11893315,480368,22825894,11412947,
336,2021-12-02T00:00:00,71606,26486,5024,,24199995,11919503,501817,22835372,11417686,
337,2021-12-03T00:00:00,73392,25097,5156,,24273387,11944304,521752,22845104,11422552,
338,2021-12-04T00:00:00,81130,27783,6057,47271,24354517,11971794,543469,,11428325,807391
339,2021-12-05T00:00:00,62612,31926,4400,26266,24417129,12003425,570987,,11432438,833553
340,2021-12-06T00:00:00,38618,19141,2709,16752,24455747,12022277,587412,,11434865,850227
341,2021-12-07T00:00:00,60261,14846,4459,40943,24516008,12036852,597789,,11439063,891096
342,2021-12-08T00:00:00,73430,19053,4674,49700,24589438,12055628,612158,,11443470,940718
343,2021-12-09T00:00:00,74473,18271,4332,51851,24663911,12073590,626089,,11447501,992484
344,2021-12-10T00:00:00,77455,17587,4641,55219,24741366,12090896,639030,,11451866,1047622
345,2021-12-11T00:00:00,83156,20402,5817,56925,24824522,12111009,653601,,11457408,1104461
346,2021-12-12T00:00:00,60740,22696,4150,33852,24885262,12133425,672141,,11461284,1138224
347,2021-12-13T00:00:00,34922,11600,2406,20893,24920184,12144728,681325,,11463403,1159022
348,2021-12-14T00:00:00,101947,8998,3854,89052,25022131,12153416,686454,,11466962,1247954
349,2021-12-15T00:00:00,127667,12428,4501,110703,25149798,12165540,694371,,11471169,1358557
350,2021-12-16T00:00:00,139314,12452,4237,122612,25289112,12177706,702576,,11475130,1481070
351,2021-12-17T00:00:00,159141,12397,4506,142215,25448253,12189828,710458,,11479370,1623188
352,2021-12-18T00:00:00,175560,13522,4916,157079,25623813,12203056,719052,,11484004,1780172
353,2021-12-19T00:00:00,140412,18156,3927,118296,25764225,12220911,733273,,11487638,1898357
354,2021-12-20T00:00:00,106809,10305,2743,93716,25871034,12230948,740825,,11490123,1991975
355,2021-12-21T00:00:00,215208,12962,4309,197915,26086242,12243594,749471,,11494123,2189769
356,2021-12-22T00:00:00,237192,14419,5191,217697,26323434,12257714,758685,,11499029,2407348
357,2021-12-23T00:00:00,257400,11712,5077,240516,26580834,12269122,765314,,11503808,2647758
358,2021-12-24T00:00:00,223374,9443,4557,209312,26804208,12278268,770196,,11508072,2856954
359,2021-12-25T00:00:00,89690,3885,2501,83316,26893898,12281878,771575,,11510303,2940163
360,2021-12-26T00:00:00,11892,387,355,11140,26905790,12281973,771599,,11510374,2951173
361,2021-12-27T00:00:00,46927,1493,1112,44292,26952717,12283221,771973,,11511248,2995345
362,2021-12-28T00:00:00,144751,6099,3998,134595,27097468,12289026,774063,,11514963,3129809
363,2021-12-29T00:00:00,175448,9373,4573,161431,27272916,12298104,778859,,11519245,3291113
364,2021-12-30T00:00:00,200029,10127,5340,184520,27472945,12307928,783631,,11524297,3475499
365,2021-12-31T00:00:00,195178,10007,5793,179127,27668123,12317646,787836,,11529810,3654500
366,2022-01-01T00:00:00,96935,5378,3874,87358,27765058,12322715,789332,,11533383,3741709
367,2022-01-02T00:00:00,19436,939,924,17444,27784494,12323363,789338,,11534025,3759007
368,2022-01-03T00:00:00,88243,4772,4591,78799,27872737,12327825,789511,,11538314,3837653
369,2022-01-04T00:00:00,146346,5996,5312,134998,28019083,12333493,790182,,11543311,3972495
370,2022-01-05T00:00:00,177456,7618,7291,162375,28196539,12340757,790498,,11550259,4134710
371,2022-01-06T00:00:00,191496,7201,6781,176989,28388035,12347639,790907,,11556732,4311544
372,2022-01-07T00:00:00,191214,7952,6986,175465,28579249,12355247,791861,,11563386,4486836
373,2022-01-08T00:00:00,181629,8619,6630,165195,28760878,12363534,793837,,11569697,4651875
374,2022-01-09T00:00:00,131084,9863,7175,113953,28891962,12373075,796520,,11576555,4765668
375,2022-01-10T00:00:00,90553,5107,4489,80826,28982515,12377860,797128,,11580732,4846341
376,2022-01-11T00:00:00,138846,6150,6562,125428,29121361,12383663,796703,,11586960,4971579
377,2022-01-12T00:00:00,156992,8155,8047,138666,29278353,12391489,796806,,11594683,5110077
378,2022-01-13T00:00:00,162650,9205,9211,141525,29441003,12400332,796786,,11603546,5251419
379,2022-01-14T00:00:00,159838,10750,10372,136025,29600841,12410721,797159,,11613562,5387246
380,2022-01-15T00:00:00,161181,11009,11669,135869,29762022,12421360,796488,,11624872,5522922
381,2022-01-16T00:00:00,109764,9288,9669,89449,29871786,12430286,796100,,11634186,5612153
382,2022-01-17T00:00:00,65772,5934,6563,52635,29937558,12435885,795461,,11640424,5664603
383,2022-01-18T00:00:00,36092,2003,2125,31142,29973650,12437533,795328,,11642205,5695549
384,2022-01-19T00:00:00,101301,5580,6713,85947,30074951,12442713,794177,,11648536,5781269
385,2022-01-20T00:00:00,103577,6321,6999,85720,30178528,12448650,793491,,11655159,5866766
386,2022-01-21T00:00:00,102080,6228,8054,82485,30280608,12454474,791651,,11662823,5949023
387,2022-01-22T00:00:00,102559,8710,12067,78105,30383167,12462795,788287,,11674508,6026900
388,2022-01-23T00:00:00,76673,7305,13985,54783,30459840,12469757,781600,,11688157,6081461
389,2022-01-24T00:00:00,42257,3194,7934,30740,30502097,12472587,776842,,11695745,6111994
390,2022-01-25T00:00:00,62554,3756,8365,48114,30564651,12475965,772218,,11703747,6159890
391,2022-01-26T00:00:00,77872,4912,13165,55687,30642523,12480500,763960,,11716540,6215335
392,2022-01-27T00:00:00,78057,4893,13244,56035,30720580,12485021,755599,,11729422,6271133
393,2022-01-28T00:00:00,77267,4671,13671,53885,30797847,12489334,746586,,11742748,6324799
394,2022-01-29T00:00:00,84803,5529,17707,58105,30882650,12494500,734401,,11760099,6382660
395,2022-01-30T00:00:00,66489,5025,20621,40149,30949139,12499183,718791,,11780392,6422584
396,2022-01-31T00:00:00,34739,2175,9880,22345,30983878,12501039,711077,,11789962,6444740
397,2022-02-01T00:00:00,51341,3267,9659,36520,31035219,12503953,704675,,11799278,6481035
398,2022-02-02T00:00:00,57699,3844,12392,38677,31092918,12507467,696112,,11811355,6519513
399,2022-02-03T00:00:00,52571,3610,11506,34297,31145489,12510700,688204,,11822496,6553559
400,2022-02-04T00:00:00,43076,2947,10556,27277,31188565,12513337,680585,,11832752,6580642
401,2022-02-05T00:00:00,58705,3738,14469,37558,31247270,12516743,669842,,11846901,6617987
402,2022-02-06T00:00:00,49853,3639,16113,29571,31297123,12520059,657363,,11862696,6647334
403,2022-02-07T00:00:00,23226,1691,7807,13436,31320349,12521424,651234,,11870190,6660546
404,2022-02-08T00:00:00,33375,2353,7240,21966,31353724,12523447,646340,,11877107,6682279
405,2022-02-09T00:00:00,38868,2781,8912,24406,31392592,12525870,640203,,11885667,6706433
406,2022-02-10T00:00:00,37529,2763,8832,22549,31430121,12528297,634130,,11894167,6728752
407,2022-02-11T00:00:00,39434,2721,10287,23000,31469555,12530672,626555,,11904117,6751514
408,2022-02-12T00:00:00,42034,2954,11452,25311,31511589,12533292,618046,,11915246,6776601
409,2022-02-13T00:00:00,36311,2801,13138,19939,31547900,12535806,607706,,11928100,6796342
410,2022-02-14T00:00:00,16968,1175,6118,9467,31564868,12536706,602755,,11933951,6805609
411,2022-02-15T00:00:00,19343,1384,4745,11874,31584211,12537767,599384,,11938383,6817256
412,2022-02-16T00:00:00,26013,1765,7728,14945,31610224,12539235,593417,,11945818,6832000
413,2022-02-17T00:00:00,26752,1681,7518,14983,31636976,12540561,587571,,11952990,6846728
414,2022-02-18T00:00:00,23930,1353,6604,13672,31660906,12541597,582308,,11959289,6860191
415,2022-02-19T00:00:00,37830,1902,8335,26050,31698736,12543168,575870,,11967298,6886000
416,2022-02-20T00:00:00,32565,1494,7960,22803,31731301,12544362,569396,,11974966,6908599
417,2022-02-21T00:00:00,17499,913,3677,12755,31748800,12544980,566623,,11978357,6921143
418,2022-02-22T00:00:00,9099,428,1549,6953,31757899,12545119,565497,,11979622,6927886
419,2022-02-23T00:00:00,25326,1327,4790,17290,31783225,12546136,562027,,11984109,6944940
420,2022-02-24T00:00:00,24562,1398,5233,15476,31807787,12547213,558188,,11989025,6960173
421,2022-02-25T00:00:00,23091,1388,5135,14503,31830878,12548307,554434,,11993873,6974450
422,2022-02-26T00:00:00,25224,1383,5908,16554,31856102,12549380,549902,,11999478,6990778
423,2022-02-27T00:00:00,26948,1369,7365,17700,31883050,12550480,543895,,12006585,7008283
424,2022-02-28T00:00:00,10127,594,2529,6745,31893177,12550821,541952,,12008869,7014845
425,2022-03-01T00:00:00,13184,943,3147,8161,31906361,12551459,539738,,12011721,7022789
426,2022-03-02T00:00:00,15407,1163,3575,9614,31921768,12552361,537319,,12015042,7032226
427,2022-03-03T00:00:00,14292,1077,3224,8686,31936060,12553127,535165,,12017962,7040681
428,2022-03-04T00:00:00,14464,989,3441,8313,31950524,12553795,532709,,12021086,7048741
429,2022-03-05T00:00:00,18526,1276,4995,11182,31969050,12554762,528979,,12025783,7059699
430,2022-03-06T00:00:00,16508,1087,5522,9602,31985558,12555570,524538,,12031032,7069094
431,2022-03-07T00:00:00,5943,464,1858,3509,31991501,12555749,523137,,12032612,7072386
432,2022-03-08T00:00:00,7354,697,1937,4158,31998855,12556168,521890,,12034278,7076345
433,2022-03-09T00:00:00,11152,906,2735,6404,32010007,12556798,520055,,12036743,7082547
434,2022-03-10T00:00:00,12753,1044,3251,6835,32022760,12557565,517841,,12039724,7089169
435,2022-03-11T00:00:00,12883,903,3406,6864,32035643,12558179,515330,,12042849,7095817
436,2022-03-12T00:00:00,14678,1045,4179,8310,32050321,12558952,512193,,12046759,7103923
437,2022-03-13T00:00:00,14742,1090,4997,8330,32065063,12559751,508282,,12051469,7112016
438,2022-03-14T00:00:00,6329,448,2228,3497,32071392,12559929,506499,,12053430,7115299
439,2022-03-15T00:00:00,10195,791,2624,5972,32081587,12560430,504654,,12055776,7121057
440,2022-03-16T00:00:00,13051,932,3660,6950,32094638,12561074,501923,,12059151,7127777
441,2022-03-17T00:00:00,13180,1047,3957,6756,32107818,12561834,499006,,12062828,7134314
442,2022-03-18T00:00:00,11901,911,3144,6432,32119719,12562443,496763,,12065680,7140523
443,2022-03-19T00:00:00,14434,1002,4161,7899,32134153,12563166,493602,,12069564,7148204
444,2022-03-20T00:00:00,11738,989,3955,6368,32145891,12563884,490631,,12073253,7154364
445,2022-03-21T00:00:00,5056,414,1589,2813,32150947,12564039,489452,,12074587,7156974
446,2022-03-22T00:00:00,6701,552,1556,3886,32157648,12564305,488443,,12075862,7160645
447,2022-03-23T00:00:00,9963,784,2296,5192,32167611,12564774,486928,,12077846,7165596
448,2022-03-24T00:00:00,9288,723,2375,4607,32176899,12565233,485267,,12079966,7169999
449,2022-03-25T00:00:00,9217,782,2151,4746,32186116,12565752,483890,,12081862,7174533
450,2022-03-26T00:00:00,10919,934,2831,5503,32197035,12566409,481991,,12084418,7179817
451,2022-03-27T00:00:00,10221,909,3537,5299,32207256,12567059,479359,,12087700,7184905
452,2022-03-28T00:00:00,3577,319,1107,1986,32210833,12567138,478568,,12088570,7186697
453,2022-03-29T00:00:00,5334,498,1208,2687,32216167,12567351,477852,,12089499,7189162
454,2022-03-30T00:00:00,7848,747,1833,4121,32224015,12567820,476761,,12091059,7193059
455,2022-03-31T00:00:00,8645,689,1924,4412,32232660,12568220,475520,,12092700,7197249
456,2022-04-01T00:00:00,9298,801,1911,4884,32241958,12568729,474401,,12094328,7201894
457,2022-04-02T00:00:00,10428,885,2208,5568,32252386,12569327,473066,,12096261,7207245
458,2022-04-03T00:00:00,9198,880,2567,5063,32261584,12569953,471373,,12098580,7212109
459,2022-04-04T00:00:00,4196,387,1005,2406,32265780,12570079,470752,,12099327,7214312
460,2022-04-05T00:00:00,6063,598,1034,3050,32271843,12570337,470310,,12100027,7217088
461,2022-04-06T00:00:00,8367,715,1477,4374,32280210,12570761,469543,,12101218,7221235
462,2022-04-07T00:00:00,10333,733,1686,4835,32290543,12571195,468585,,12102610,7225828
463,2022-04-08T00:00:00,23986,811,1580,4835,32314529,12571728,467810,,12103918,7230447
464,2022-04-09T00:00:00,30475,969,1972,5893,32345004,12572399,466798,,12105601,7236117
465,2022-04-10T00:00:00,24849,976,2387,5331,32369853,12573118,465381,,12107737,7241248
466,2022-04-11T00:00:00,12568,385,874,2432,32382421,12573254,464888,,12108366,7243479
467,2022-04-12T00:00:00,28109,691,1017,3535,32410530,12573643,464555,,12109088,7246782
468,2022-04-13T00:00:00,37776,853,1559,4928,32448306,12574197,463845,,12110352,7251480
469,2022-04-14T00:00:00,37885,762,1611,4910,32486191,12574648,462993,,12111655,7256138
470,2022-04-15T00:00:00,43393,1230,2101,6726,32529584,12575580,462118,,12113462,7262627
471,2022-04-16T00:00:00,8087,358,650,1736,32537671,12575678,461824,,12113854,7264147
472,2022-04-17T00:00:00,21004,870,1922,4315,32558675,12576264,460765,,12115499,7268239
473,2022-04-18T00:00:00,5457,305,462,1288,32564132,12576283,460603,,12115680,7269287
474,2022-04-19T00:00:00,22647,616,772,3100,32586779,12576618,460438,,12116180,7272168
475,2022-04-20T00:00:00,40326,1063,1395,4617,32627105,12577355,460103,,12117252,7276521
476,2022-04-21T00:00:00,38748,941,1602,4679,32665853,12578001,459434,,12118567,7280966
477,2022-04-22T00:00:00,35615,1013,1428,4266,32701468,12578741,459012,,12119729,7285013
478,2022-04-23T00:00:00,34641,1005,1733,4712,32736109,12579464,458281,,12121183,7289488
479,2022-04-24T00:00:00,20807,1022,1883,3777,32756916,12580236,457417,,12122819,7293071
480,2022-04-25T00:00:00,8299,453,691,1707,32765215,12580420,457178,,12123242,7294562
481,2022-04-26T00:00:00,24604,732,944,3138,32789819,12580860,456960,,12123900,7297463
482,2022-04-27T00:00:00,33593,955,1368,3935,32823412,12581540,456539,,12125001,7301182
483,2022-04-28T00:00:00,32829,927,1412,3928,32856241,12582194,456045,,12126149,7304887
484,2022-04-29T00:00:00,32053,1098,1378,3909,32888294,12582995,455758,,12127237,7308568
485,2022-04-30T00:00:00,30274,923,1536,4020,32918568,12583621,455138,,12128483,7312352
486,2022-05-01T00:00:00,16749,768,1579,2969,32935317,12584093,454322,,12129771,7315079
487,2022-05-02T00:00:00,5933,309,524,1097,32941250,12584106,454103,,12130003,7315949
488,2022-05-03T00:00:00,20921,588,829,2345,32962171,12584389,453856,,12130533,7318055
489,2022-05-04T00:00:00,29413,800,1091,3293,32991584,12584880,453560,,12131320,7321099
490,2022-05-05T00:00:00,29091,872,1160,3125,33020675,12585440,453262,,12132178,7323980
491,2022-05-06T00:00:00,29084,1146,1280,2983,33049759,12586299,453123,,12133176,7326737
492,2022-05-07T00:00:00,28482,868,1260,3111,33078241,12586877,452726,,12134151,7329624
493,2022-05-08T00:00:00,15996,896,1309,2322,33094237,12587516,452311,,12135205,7331745
494,2022-05-09T00:00:00,5896,292,474,943,33100133,12587543,452123,,12135420,7332479
495,2022-05-10T00:00:00,21221,696,718,2119,33121354,12587922,452094,,12135828,7334339
496,2022-05-11T00:00:00,28943,836,1079,2655,33150297,12588427,451847,,12136580,7336722
497,2022-05-12T00:00:00,28231,800,1082,2510,33178528,12588930,451561,,12137369,7338991
498,2022-05-13T00:00:00,27591,878,1117,2468,33206119,12589498,451318,,12138180,7341202
499,2022-05-14T00:00:00,25688,808,1096,2609,33231807,12589990,451023,,12138967,7343556
500,2022-05-15T00:00:00,14845,751,1274,2055,33246652,12590471,450493,,12139978,7345394
501,2022-05-16T00:00:00,6381,325,532,1047,33253033,12590559,450282,,12140277,7346255
502,2022-05-17T00:00:00,19594,585,775,1741,33272627,12590830,450085,,12140745,7347748
503,2022-05-18T00:00:00,26538,877,1097,2272,33299165,12591443,449860,,12141583,7349805
504,2022-05-19T00:00:00,24430,682,1155,2159,33323595,12591858,449380,,12142478,7351747
505,2022-05-20T00:00:00,24260,801,1136,2215,33347855,12592392,449041,,12143351,7353745
506,2022-05-21T00:00:00,22396,692,1167,2345,33370251,12592776,448557,,12144219,7355849
507,2022-05-22T00:00:00,10555,551,888,1486,33380806,12593066,448215,,12144851,7357118
508,2022-05-23T00:00:00,4562,241,462,785,33385368,12593049,447992,,12145057,7357695
509,2022-05-24T00:00:00,2612,118,177,433,33387980,12592914,447931,,12144983,7357919
510,2022-05-25T00:00:00,19355,655,945,1952,33407335,12593304,447631,,12145673,7359662
511,2022-05-26T00:00:00,20635,662,948,1908,33427970,12593693,447339,,12146354,7361348
512,2022-05-27T00:00:00,21754,816,1057,2075,33449724,12594223,447095,,12147128,7363192
513,2022-05-28T00:00:00,19398,721,1164,2145,33469122,12594675,446649,,12148026,7365124
514,2022-05-29T00:00:00,12107,761,1280,1725,33481229,12595201,446123,,12149078,7366657
515,2022-05-30T00:00:00,4579,311,549,751,33485808,12595266,445882,,12149384,7367210
516,2022-05-31T00:00:00,13545,572,749,1666,33499353,12595536,445699,,12149837,7368636
517,2022-06-01T00:00:00,16607,702,970,1877,33515960,12595934,445429,,12150505,7370259
518,2022-06-02T00:00:00,14598,556,866,1673,33530558,12596178,445112,,12151066,7371691
519,2022-06-03T00:00:00,16098,697,1095,1813,33546656,12596599,444708,,12151891,7373287
520,2022-06-04T00:00:00,13315,648,1162,1842,33559971,12596991,444190,,12152801,7374928
521,2022-06-05T00:00:00,7866,587,1109,1432,33567837,12597329,443664,,12153665,7376168
522,2022-06-06T00:00:00,3293,206,444,641,33571130,12597289,443423,,12153866,7376610
523,2022-06-07T00:00:00,11210,474,725,1368,33582340,12597464,443167,,12154297,7377734
524,2022-06-08T00:00:00,14060,667,1013,1608,33596400,12597873,442816,,12155057,7379124
525,2022-06-09T00:00:00,13368,662,922,1673,33609768,12598247,442551,,12155696,7380565
526,2022-06-10T00:00:00,13847,685,1066,1695,33623615,12598646,442162,,12156484,7382030
527,2022-06-11T00:00:00,12978,615,1031,1864,33636593,12598976,441744,,12157232,7383672
528,2022-06-12T00:00:00,8094,644,1236,1500,33644687,12599364,441148,,12158216,7384967
529,2022-06-13T00:00:00,3186,284,422,709,33647873,12599382,441005,,12158377,7385467
530,2022-06-14T00:00:00,10125,511,666,1262,33657998,12599604,440844,,12158760,7386491
531,2022-06-15T00:00:00,13500,470,829,1620,33671498,12599781,440483,,12159298,7387876
532,2022-06-16T00:00:00,12536,494,855,1616,33684034,12599971,440117,,12159854,7389246
533,2022-06-17T00:00:00,11687,480,816,1652,33695721,12600166,439774,,12160392,7390664
534,2022-06-18T00:00:00,11445,436,873,1860,33707166,12600333,439334,,12160999,7392301
535,2022-06-19T00:00:00,6998,482,896,1420,33714164,12600567,438919,,12161648,7393511
536,2022-06-20T00:00:00,2286,147,301,643,33716450,12600494,438759,,12161735,7393986
537,2022-06-21T00:00:00,9538,358,614,1381,33725988,12600565,438498,,12162067,7395119
538,2022-06-22T00:00:00,13606,406,724,1702,33739594,12600699,438173,,12162526,7396596
539,2022-06-23T00:00:00,13697,401,775,1680,33753291,12600838,437796,,12163042,7398065
540,2022-06-24T00:00:00,15361,435,811,1671,33768652,12601013,437416,,12163597,7399521
541,2022-06-25T00:00:00,14465,425,851,1711,33783117,12601180,436979,,12164201,7401026
542,2022-06-26T00:00:00,8156,432,885,1280,33791273,12601354,436519,,12164835,7402092
543,2022-06-27T00:00:00,3211,171,364,593,33794484,12601277,436322,,12164955,7402479
544,2022-06-28T00:00:00,9615,370,556,1223,33804099,12601362,436132,,12165230,7403470
545,2022-06-29T00:00:00,13307,413,728,1628,33817406,12601486,435815,,12165671,7404859
546,2022-06-30T00:00:00,12225,483,845,1577,33829631,12601686,435451,,12166235,7406204
547,2022-07-01T00:00:00,13035,548,970,1947,33842666,12601979,435024,,12166955,7407946
548,2022-07-02T00:00:00,1609,110,115,362,33844275,12601813,435017,,12166796,7408076
549,2022-07-03T00:00:00,5158,261,493,958,33849433,12601819,434776,,12167043,7408820
550,2022-07-04T00:00:00,2756,131,279,614,33852189,12601704,434627,,12167077,7409238
551,2022-07-05T00:00:00,11139,372,598,1572,33863328,12601782,434393,,12167389,7410565
552,2022-07-06T00:00:00,15954,545,857,2007,33879282,12602033,434075,,12167958,7412331
553,2022-07-07T00:00:00,15659,521,832,1922,33894941,12602267,433763,,12168504,7414001
554,2022-07-08T00:00:00,17879,554,870,2244,33912820,12602517,433446,,12169071,7415996
555,2022-07-09T00:00:00,14135,450,597,1841,33926955,12602694,433298,,12169396,7417604
556,2022-07-10T00:00:00,8742,475,752,1501,33935697,12602923,433020,,12169903,7418900
557,2022-07-11T00:00:00,4093,199,331,870,33939790,12602858,432885,,12169973,7419551
558,2022-07-12T00:00:00,12104,413,523,1653,33951894,12602973,432770,,12170203,7420951
559,2022-07-13T00:00:00,16709,562,770,2141,33968603,12603240,432556,,12170684,7422850
560,2022-07-14T00:00:00,16858,486,674,2023,33985461,12603422,432357,,12171065,7424635
561,2022-07-15T00:00:00,28887,600,822,2181,34014348,12603722,432134,,12171588,7426575
562,2022-07-16T00:00:00,30289,585,772,2324,34044637,12603995,431938,,12172057,7428649
563,2022-07-17T00:00:00,22922,538,636,1883,34067559,12604297,431837,,12172460,7430339
564,2022-07-18T00:00:00,11390,187,254,852,34078949,12604216,431765,,12172451,7430969
565,2022-07-19T00:00:00,28945,592,590,2132,34107894,12604535,431764,,12172771,7432870
566,2022-07-20T00:00:00,37630,842,923,2588,34145524,12605100,431678,,12173422,7435223
567,2022-07-21T00:00:00,36349,732,810,2804,34181873,12605546,431593,,12173953,7437788
568,2022-07-22T00:00:00,35793,827,888,2681,34217666,12606088,431526,,12174562,7440233
569,2022-07-23T00:00:00,35138,820,913,2825,34252804,12606597,431425,,12175172,7442804
570,2022-07-24T00:00:00,21729,602,805,1770,34274533,12606938,431219,,12175719,7444351
571,2022-07-25T00:00:00,11932,308,311,1080,34286465,12606966,431211,,12175755,7445204
572,2022-07-26T00:00:00,26084,621,601,2209,34312549,12607305,431230,,12176075,7447171
573,2022-07-27T00:00:00,32461,810,844,2647,34345010,12607860,431194,,12176666,7449610
574,2022-07-28T00:00:00,31533,725,884,2604,34376543,12608292,431031,,12177261,7451967
575,2022-07-29T00:00:00,29987,1791,876,2640,34406530,12609793,431942,,12177851,7454358
576,2022-07-30T00:00:00,25822,2525,745,2432,34432352,12612045,433720,,12178325,7456563
577,2022-07-31T00:00:00,14292,1068,541,1561,34446644,12612848,434243,,12178605,7457899
578,2022-08-01T00:00:00,5911,336,223,681,34452555,12612926,434354,,12178572,7458357
579,2022-08-02T00:00:00,4473,305,135,600,34457028,12612961,434520,,12178441,7458735
580,2022-08-03T00:00:00,22928,2635,737,2234,34479956,12615323,436414,,12178909,7460736
581,2022-08-04T00:00:00,22225,2480,677,2129,34502181,12617478,438211,,12179267,7462604
582,2022-08-05T00:00:00,21789,2756,743,2064,34523970,12619955,440216,,12179739,7464442
583,2022-08-06T00:00:00,19642,2877,658,1990,34543612,12622524,442429,,12180095,7466177
584,2022-08-07T00:00:00,12698,2235,619,1418,34556310,12624487,444039,,12180448,7467380
585,2022-08-08T00:00:00,4766,570,188,603,34561076,12624775,444414,,12180361,7467751
586,2022-08-09T00:00:00,14006,1466,557,1589,34575082,12625957,445317,,12180640,7469101
587,2022-08-10T00:00:00,19121,2363,717,1988,34594203,12628048,446961,,12181087,7470862
588,2022-08-11T00:00:00,17073,2043,718,1851,34611276,12629818,448284,,12181534,7472483
589,2022-08-12T00:00:00,16979,2048,734,1850,34628255,12631580,449597,,12181983,7474106
590,2022-08-13T00:00:00,15946,2222,762,1805,34644201,12633523,451055,,12182468,7475675
591,2022-08-14T00:00:00,9523,1621,618,1081,34653724,12634857,452054,,12182803,7476522
592,2022-08-15T00:00:00,3868,388,268,477,34657592,12634994,452171,,12182823,7476792
593,2022-08-16T00:00:00,10801,1073,514,1355,34668393,12635769,452728,,12183041,7477898
594,2022-08-17T00:00:00,16093,1834,738,1778,34684486,12637317,453823,,12183494,7479441
595,2022-08-18T00:00:00,14925,1640,748,1689,34699411,12638636,454711,,12183925,7480862
596,2022-08-19T00:00:00,15306,1846,747,1544,34714717,12640207,455806,,12184401,7482174
597,2022-08-20T00:00:00,14277,1640,739,1543,34728994,12641559,456701,,12184858,7483480
598,2022-08-21T00:00:00,9895,1532,659,1163,34738889,12642830,457570,,12185260,7484430
599,2022-08-22T00:00:00,4162,481,270,561,34743051,12643015,457778,,12185237,7484738
600,2022-08-23T00:00:00,11129,1248,554,1492,34754180,12643959,458469,,12185490,7485979
601,2022-08-24T00:00:00,14752,1808,868,2185,34768932,12645499,459409,,12186090,7487936
602,2022-08-25T00:00:00,14026,1718,780,2120,34782958,12646932,460340,,12186592,7489813
603,2022-08-26T00:00:00,13923,1687,815,2090,34796881,12648330,461205,,12187125,7491658
604,2022-08-27T00:00:00,12411,1484,877,1997,34809292,12649491,461806,,12187685,7493391
605,2022-08-28T00:00:00,7922,1258,621,1396,34817214,12650495,462441,,12188054,7494572
606,2022-08-29T00:00:00,3394,504,283,681,34820608,12650727,462657,,12188070,7495027
607,2022-08-30T00:00:00,9904,1169,649,1855,34830512,12651543,463171,,12188372,7496583
608,2022-08-31T00:00:00,13507,1627,946,2310,34844019,12652887,463848,,12189039,7498656
609,2022-09-01T00:00:00,12899,1721,910,2137,34856918,12654317,464655,,12189662,7500551
610,2022-09-02T00:00:00,15041,1615,991,4919,34871959,12655662,465271,,12190391,7505249
611,2022-09-03T00:00:00,14709,1525,920,5513,34886668,12656916,465873,,12191043,7510537
612,2022-09-04T00:00:00,8660,1010,675,3234,34895328,12657670,466200,,12191470,7513555
613,2022-09-05T00:00:00,3550,321,229,1383,34898878,12657730,466289,,12191441,7514718
614,2022-09-06T00:00:00,2461,157,113,1128,34901339,12657641,466330,,12191311,7515643
615,2022-09-07T00:00:00,10922,1018,587,3491,34912261,12658369,466759,,12191610,7518888
616,2022-09-08T00:00:00,10864,1021,524,2790,34923125,12659069,467253,,12191816,7521408
617,2022-09-09T00:00:00,9580,1012,488,2501,34932705,12659796,467772,,12192024,7523676
618,2022-09-10T00:00:00,10629,1266,551,3162,34943334,12660792,468481,,12192311,7526610
619,2022-09-11T00:00:00,9404,982,667,3734,34952738,12661531,468790,,12192741,7530139
620,2022-09-12T00:00:00,3124,295,203,1079,34955862,12661550,468876,,12192674,7530986
621,2022-09-13T00:00:00,6012,542,281,1132,34961874,12661815,469128,,12192687,7531884
622,2022-09-14T00:00:00,14478,798,432,1843,34976352,12662302,469490,,12192812,7533466
623,2022-09-15T00:00:00,15743,780,408,1533,34992095,12662770,469858,,12192912,7534734
624,2022-09-16T00:00:00,17749,766,445,1690,35009844,12663283,470173,,12193110,7536208
625,2022-09-17T00:00:00,17608,722,456,1665,35027452,12663710,470435,,12193275,7537625
626,2022-09-18T00:00:00,11208,776,451,1684,35038660,12664231,470758,,12193473,7539091
627,2022-09-19T00:00:00,4977,403,288,670,35043637,12664370,470870,,12193500,7539551
628,2022-09-20T00:00:00,13749,438,327,941,35057386,12664501,470979,,12193522,7540232
629,2022-09-21T00:00:00,23027,645,407,1496,35080413,12664854,471212,,12193642,7541486
630,2022-09-22T00:00:00,22903,637,398,1378,35103316,12665193,471445,,12193748,7542609
631,2022-09-23T00:00:00,22934,727,599,1416,35126250,12665629,471569,,12194060,7543778
632,2022-09-24T00:00:00,21679,736,689,1498,35147929,12666076,471612,,12194464,7545043
633,2022-09-25T00:00:00,11315,595,702,1355,35159244,12666399,471500,,12194899,7546169
634,2022-09-26T00:00:00,4561,192,218,594,35163805,12666310,471468,,12194842,7546524
635,2022-09-27T00:00:00,37648,498,364,1499,35201453,12666548,471598,,12194950,7547803
636,2022-09-28T00:00:00,50957,730,670,1902,35252410,12667019,471657,,12195362,7549488
637,2022-09-29T00:00:00,47991,637,739,1836,35300401,12667348,471548,,12195800,7551057
638,2022-09-30T00:00:00,47265,679,806,2001,35347666,12667708,471419,,12196289,7552784
639,2022-10-01T00:00:00,34436,527,632,1545,35382102,12667936,471312,,12196624,7554071
640,2022-10-02T00:00:00,24238,738,1025,1710,35406340,12668392,471022,,12197370,7555539
641,2022-10-03T00:00:00,10863,239,230,611,35417203,12668351,471027,,12197324,7555921
642,2022-10-04T00:00:00,32181,478,458,1168,35449384,12668521,471043,,12197478,7556823
643,2022-10-05T00:00:00,40417,625,740,1558,35489801,12668845,470923,,12197922,7558129
644,2022-10-06T00:00:00,38678,610,652,1567,35528479,12669166,470879,,12198287,7559446
645,2022-10-07T00:00:00,42231,660,852,1742,35570710,12669492,470679,,12198813,7560898
646,2022-10-08T00:00:00,37380,784,1145,2120,35608090,12669965,470312,,12199653,7562759
647,2022-10-09T00:00:00,18811,549,727,1557,35626901,12670253,470131,,12200122,7564094
648,2022-10-10T00:00:00,6862,170,370,567,35633763,12670139,469929,,12200210,7564414
649,2022-10-11T00:00:00,4986,124,111,318,35638749,12669985,469937,,12200048,7564502
650,2022-10-12T00:00:00,35098,579,684,1426,35673847,12670243,469830,,12200413,7565651
651,2022-10-13T00:00:00,36747,644,857,1621,35710594,12670544,469615,,12200929,7566980
652,2022-10-14T00:00:00,36960,621,752,1539,35747554,12670851,469481,,12201370,7568250
653,2022-10-15T00:00:00,35444,716,1013,1624,35782998,12671299,469181,,12202118,7569646
654,2022-10-16T00:00:00,20660,654,1024,1593,35803658,12671699,468805,,12202894,7571019
655,2022-10-17T00:00:00,7349,206,477,538,35811007,12671635,468533,,12203102,7571327
656,2022-10-18T00:00:00,36415,458,500,1397,35847422,12671785,468487,,12203298,7572462
657,2022-10-19T00:00:00,49875,619,729,1983,35897297,12672115,468374,,12203741,7574204
658,2022-10-20T00:00:00,51265,623,648,2048,35948562,12672437,468347,,12204090,7575999
659,2022-10-21T00:00:00,52835,699,618,1938,36001397,12672824,468425,,12204399,7577677
660,2022-10-22T00:00:00,50853,752,905,2308,36052250,12673259,468267,,12204992,7579719
661,2022-10-23T00:00:00,30623,579,783,2118,36082873,12673536,468057,,12205479,7581582
662,2022-10-24T00:00:00,14130,231,270,979,36097003,12673481,468013,,12205468,7582315
663,2022-10-25T00:00:00,41346,474,488,1816,36138349,12673627,467996,,12205631,7583852
664,2022-10-26T00:00:00,51616,619,660,2122,36189965,12673924,467951,,12205973,7585705
665,2022-10-27T00:00:00,50092,610,768,2163,36240057,12674224,467787,,12206437,7587609
666,2022-10-28T00:00:00,49775,590,675,2093,36289832,12674474,467699,,12206775,7589407
667,2022-10-29T00:00:00,50579,736,778,2217,36340411,12674881,467653,,12207228,7591341
668,2022-10-30T00:00:00,28388,664,930,2034,36368799,12675283,467384,,12207899,7593145
669,2022-10-31T00:00:00,12436,199,234,777,36381235,12675225,467346,,12207879,7593705
670,2022-11-01T00:00:00,33075,341,196,1220,36414310,12675238,467485,,12207753,7594647
671,2022-11-02T00:00:00,44269,576,622,1904,36458579,12675508,467437,,12208071,7596273
672,2022-11-03T00:00:00,44172,540,605,1856,36502751,12675749,467369,,12208380,7597868
673,2022-11-04T00:00:00,44624,652,528,2024,36547375,12676117,467487,,12208630,7599653
674,2022-11-05T00:00:00,45191,647,755,2370,36592566,12676488,467376,,12209112,7601778
675,2022-11-06T00:00:00,26012,560,771,2096,36618578,12676728,467163,,12209565,7603595
676,2022-11-07T00:00:00,10710,243,235,876,36629288,12676723,467168,,12209555,7604265
677,2022-11-08T00:00:00,33463,487,395,1584,36662751,12676943,467257,,12209686,7605623
678,2022-11-09T00:00:00,40522,605,570,1966,36703273,12677260,467291,,12209969,7607345
679,2022-11-10T00:00:00,39161,626,547,1926,36742434,12677598,467366,,12210232,7609021
680,2022-11-11T00:00:00,43327,638,641,2205,36785761,12677952,467362,,12210590,7610981
681,2022-11-12T00:00:00,36832,640,592,2185,36822593,12678290,467402,,12210888,7612903
682,2022-11-13T00:00:00,24258,559,770,2276,36846851,12678576,467186,,12211390,7614944
683,2022-11-14T00:00:00,10962,233,204,1023,36857813,12678543,467214,,12211329,7615733
684,2022-11-15T00:00:00,33583,484,379,1691,36891396,12678700,467315,,12211385,7617147
685,2022-11-16T00:00:00,43516,801,581,2369,36934912,12679231,467530,,12211701,7619289
686,2022-11-17T00:00:00,38316,674,646,2241,36973228,12679587,467554,,12212033,7621259
687,2022-11-18T00:00:00,40600,725,530,2326,37013828,12679995,467745,,12212250,7623308
688,2022-11-19T00:00:00,39641,1016,1031,3077,37053469,12680700,467726,,12212974,7626111
689,2022-11-20T00:00:00,22411,661,718,2440,37075880,12681121,467668,,12213453,7628349
690,2022-11-21T00:00:00,8918,197,192,970,37084798,12681081,467669,,12213412,7629132
691,2022-11-22T00:00:00,26429,479,368,1512,37111227,12681245,467776,,12213469,7630369
692,2022-11-23T00:00:00,32053,686,667,2068,37143280,12681630,467793,,12213837,7632182
693,2022-11-24T00:00:00,31892,663,750,2082,37175172,12682010,467705,,12214305,7634024
694,2022-11-25T00:00:00,30746,764,829,1949,37205918,12682499,467634,,12214865,7635742
695,2022-11-26T00:00:00,30270,907,1190,2696,37236188,12683105,467344,,12215761,7638176
696,2022-11-27T00:00:00,18670,611,944,2087,37254858,12683449,467007,,12216442,7640031
697,2022-11-28T00:00:00,7536,191,280,786,37262394,12683377,466913,,12216464,7640582
698,2022-11-29T00:00:00,21014,421,452,1291,37283408,12683513,466879,,12216634,7641627
699,2022-11-30T00:00:00,27881,647,648,1838,37311289,12683883,466876,,12217007,7643223
700,2022-12-01T00:00:00,24795,593,682,1691,37336084,12684192,466785,,12217407,7644666
701,2022-12-02T00:00:00,25044,524,630,1771,37361128,12684432,466673,,12217759,7646187
702,2022-12-03T00:00:00,25541,587,779,1944,37386669,12684742,466474,,12218268,7647907
703,2022-12-04T00:00:00,15245,499,606,1699,37401914,12684958,466363,,12218595,7649353
704,2022-12-05T00:00:00,6879,168,156,746,37408793,12684871,466370,,12218501,7649880
705,2022-12-06T00:00:00,20333,421,351,1376,37429126,12684979,466439,,12218540,7650985
706,2022-12-07T00:00:00,24755,553,609,1668,37453881,12685273,466380,,12218893,7652429
707,2022-12-08T00:00:00,23149,563,523,1760,37477030,12685575,466419,,12219156,7653957
708,2022-12-09T00:00:00,23315,636,575,1631,37500345,12685947,466479,,12219468,7655364
709,2022-12-10T00:00:00,22565,511,600,1627,37522910,12686208,466389,,12219819,7656771
710,2022-12-11T00:00:00,14197,549,785,1566,37537107,12686549,466151,,12220398,7658153
711,2022-12-12T00:00:00,5506,150,157,593,37542613,12686462,466140,,12220322,7658547
712,2022-12-13T00:00:00,17787,378,367,1125,37560400,12686575,466151,,12220424,7659442
713,2022-12-14T00:00:00,21309,511,547,1452,37581709,12686872,466111,,12220761,7660706
714,2022-12-15T00:00:00,21955,531,602,1578,37603664,12687133,466039,,12221094,7662049
715,2022-12-16T00:00:00,16280,378,450,1030,37619944,12687253,465967,,12221286,7662858
716,2022-12-17T00:00:00,18692,559,506,1273,37638636,12687563,466019,,12221544,7663899
717,2022-12-18T00:00:00,12634,529,794,1304,37651270,12687865,465753,,12222112,7664997
718,2022-12-19T00:00:00,4585,133,115,448,37655855,12687738,465767,,12221971,7665214
719,2022-12-20T00:00:00,16201,501,449,1105,37672056,12687994,465816,,12222178,7666105
720,2022-12-21T00:00:00,18464,547,551,1299,37690520,12688311,465809,,12222502,7667199
721,2022-12-22T00:00:00,18587,576,589,1743,37709107,12688658,465796,,12222862,7668741
722,2022-12-23T00:00:00,15636,580,598,1712,37724743,12688956,465773,,12223183,7670216
723,2022-12-24T00:00:00,5331,223,171,671,37730074,12688933,465825,,12223108,7670662
724,2022-12-25T00:00:00,2441,153,152,480,37732515,12688844,465819,,12223025,7670931
725,2022-12-26T00:00:00,262,12,7,48,37732777,12688619,465820,,12222799,7670770
726,2022-12-27T00:00:00,2090,99,35,305,37734867,12688509,465882,,12222627,7670890
727,2022-12-28T00:00:00,8316,337,167,975,37743183,12688595,466050,,12222545,7671638
728,2022-12-29T00:00:00,13158,584,524,1600,37756341,12688930,466108,,12222822,7673018
729,2022-12-30T00:00:00,15812,671,657,1877,37772153,12689357,466119,,12223238,7674676
730,2022-12-31T00:00:00,11228,462,387,1353,37783381,12689538,466190,,12223348,7675781
731,2023-01-01T00:00:00,3906,203,219,562,37787287,12689501,466174,,12223327,7676132
732,2023-01-02T00:00:00,651,37,14,96,37787938,12689309,466197,,12223112,7676024
733,2023-01-03T00:00:00,8190,300,151,897,37796128,12689378,466341,,12223037,7676727
734,2023-01-04T00:00:00,14714,575,547,1544,37810842,12689725,466363,,12223362,7678070
735,2023-01-05T00:00:00,16108,654,533,1794,37826950,12690134,466481,,12223653,7679649
736,2023-01-06T00:00:00,18818,718,609,2044,37845768,12690628,466587,,12224041,7681493
737,2023-01-07T00:00:00,18518,707,638,2052,37864286,12691105,466653,,12224452,7683342
738,2023-01-08T00:00:00,11609,582,608,1630,37875895,12691480,466626,,12224854,7684786
739,2023-01-09T00:00:00,5298,216,196,664,37881193,12691465,466644,,12224821,7685252
740,2023-01-10T00:00:00,12155,419,315,781,37893348,12691641,466748,,12224893,7685816
741,2023-01-11T00:00:00,15537,460,370,1092,37908885,12691852,466836,,12225016,7686692
742,2023-01-12T00:00:00,14060,448,407,972,37922945,12692048,466876,,12225172,7687442
743,2023-01-13T00:00:00,14160,424,345,1038,37937105,12692274,466954,,12225320,7688297
744,2023-01-14T00:00:00,13374,479,452,1076,37950479,12692524,466978,,12225546,7689164
745,2023-01-15T00:00:00,9041,466,506,1049,37959520,12692785,466937,,12225848,7690039
746,2023-01-16T00:00:00,3745,148,130,479,37963265,12692710,466955,,12225755,7690314
747,2023-01-17T00:00:00,8848,270,179,651,37972113,12692707,467046,,12225661,7690732
748,2023-01-18T00:00:00,10238,351,273,757,37982351,12692825,467124,,12225701,7691275
749,2023-01-19T00:00:00,10579,318,318,760,37992930,12692907,467120,,12225787,7691832
750,2023-01-20T00:00:00,9824,319,272,716,38002754,12692998,467166,,12225832,7692339
751,2023-01-21T00:00:00,11302,358,398,904,38014056,12693133,467126,,12226007,7693052
752,2023-01-22T00:00:00,7565,344,404,816,38021621,12693268,467064,,12226204,7693675
753,2023-01-23T00:00:00,3379,144,131,288,38025000,12693230,467077,,12226153,7693803
754,2023-01-24T00:00:00,8278,227,165,549,38033278,12693207,467137,,12226070,7694132
755,2023-01-25T00:00:00,10305,349,296,661,38043583,12693334,467189,,12226145,7694599
756,2023-01-26T00:00:00,6720,236,203,469,38050303,12693343,467222,,12226121,7694874
757,2023-01-27T00:00:00,6900,241,197,491,38057203,12693341,467265,,12226076,7695157
758,2023-01-28T00:00:00,9334,312,337,693,38066537,12693426,467236,,12226190,7695651
759,2023-01-29T00:00:00,5960,235,341,689,38072497,12693434,467125,,12226309,7696136
760,2023-01-30T00:00:00,1899,88,79,216,38074396,12693305,467132,,12226173,7696157
761,2023-01-31T00:00:00,5875,156,150,413,38080271,12693210,467136,,12226074,7696344
762,2023-02-01T00:00:00,7291,249,249,488,38087562,12693257,467136,,12226121,7696655
763,2023-02-02T00:00:00,6462,295,239,499,38094024,12693358,467190,,12226168,7696992
764,2023-02-03T00:00:00,6539,197,191,462,38100563,12693351,467195,,12226156,7697272
765,2023-02-04T00:00:00,6717,231,305,541,38107280,12693392,467116,,12226276,7697652
766,2023-02-05T00:00:00,4175,198,291,484,38111455,12693372,467022,,12226350,7697953
767,2023-02-06T00:00:00,1834,91,98,211,38113289,12693246,467013,,12226233,7697965
768,2023-02-07T00:00:00,4960,162,181,383,38118249,12693171,466992,,12226179,7698145
769,2023-02-08T00:00:00,5766,213,206,429,38124015,12693180,466998,,12226182,7698391
770,2023-02-09T00:00:00,6115,214,243,438,38130130,12693191,466969,,12226222,7698655
771,2023-02-10T00:00:00,5078,158,207,369,38135208,12693195,466918,,12226277,7698888
772,2023-02-11T00:00:00,6049,185,258,458,38141257,12693172,466841,,12226331,7699157
773,2023-02-12T00:00:00,4077,217,343,408,38145334,12693189,466712,,12226477,7699383
774,2023-02-13T00:00:00,1480,56,87,146,38146814,12693063,466680,,12226383,7699378
775,2023-02-14T00:00:00,3936,132,179,308,38150750,12692975,466632,,12226343,7699489
776,2023-02-15T00:00:00,4537,119,191,285,38155287,12692900,466560,,12226340,7699603
777,2023-02-16T00:00:00,4912,174,285,400,38160199,12692867,466447,,12226420,7699817
778,2023-02-17T00:00:00,4981,180,210,342,38165180,12692860,466416,,12226444,7699996
779,2023-02-18T00:00:00,5111,230,295,487,38170291,12692894,466349,,12226545,7700311
780,2023-02-19T00:00:00,3349,133,243,373,38173640,12692842,466238,,12226604,7700528
781,2023-02-20T00:00:00,1419,64,54,157,38175059,12692729,466246,,12226483,7700533
782,2023-02-21T00:00:00,912,25,14,107,38175971,12692592,466255,,12226337,7700492
783,2023-02-22T00:00:00,4133,130,213,370,38180104,12692552,466167,,12226385,7700721
784,2023-02-23T00:00:00,4261,163,231,389,38184365,12692502,466092,,12226410,7700921
785,2023-02-24T00:00:00,3026,138,229,273,38187391,12692469,465999,,12226470,7701037
786,2023-02-25T00:00:00,5011,214,539,384,38192402,12692497,465673,,12226824,7701267
787,2023-02-26T00:00:00,3472,146,681,384,38195874,12692460,465137,,12227323,7701490
788,2023-02-27T00:00:00,1070,37,57,97,38196944,12692334,465114,,12227220,7701451
789,2023-02-28T00:00:00,2721,97,163,232,38199665,12692222,465046,,12227176,7701493
790,2023-03-01T00:00:00,3845,138,428,333,38203510,12692155,464755,,12227400,7701636
791,2023-03-02T00:00:00,4586,159,496,327,38208096,12692116,464415,,12227701,7701798
792,2023-03-03T00:00:00,4363,160,357,333,38212459,12692096,464216,,12227880,7701967
793,2023-03-04T00:00:00,4962,207,623,349,38217421,12692134,463798,,12228336,7702168
794,2023-03-05T00:00:00,2532,110,449,251,38219953,12692079,463458,,12228621,7702271
795,2023-03-06T00:00:00,1156,48,37,114,38221109,12691967,463467,,12228500,7702243
796,2023-03-07T00:00:00,3211,90,171,221,38224320,12691863,463384,,12228479,7702297
797,2023-03-08T00:00:00,4311,133,412,283,38228631,12691835,463104,,12228731,7702435
798,2023-03-09T00:00:00,4607,170,451,312,38233238,12691841,462819,,12229022,7702607
799,2023-03-10T00:00:00,3932,101,136,255,38237170,12691794,462782,,12229012,7702733
800,2023-03-11T00:00:00,4046,141,169,284,38241216,12691797,462753,,12229044,7702891
801,2023-03-12T00:00:00,2882,109,234,301,38244098,12691746,462624,,12229122,7703049
802,2023-03-13T00:00:00,857,32,32,103,38244955,12691651,462622,,12229029,7703040
803,2023-03-14T00:00:00,3054,100,109,256,38248009,12691598,462613,,12228985,7703162
804,2023-03-15T00:00:00,4094,141,163,309,38252103,12691615,462591,,12229024,7703357
805,2023-03-16T00:00:00,4000,173,234,276,38256103,12691617,462528,,12229089,7703493
806,2023-03-17T00:00:00,4273,171,202,306,38260376,12691638,462494,,12229144,7703668
807,2023-03-18T00:00:00,4349,144,194,295,38264725,12691645,462444,,12229201,7703839
808,2023-03-19T00:00:00,2717,129,233,255,38267442,12691675,462340,,12229335,7704004
809,2023-03-20T00:00:00,773,31,19,73,38268215,12691584,462352,,12229232,7703965
810,2023-03-21T00:00:00,2884,70,84,199,38271099,12691529,462334,,12229195,7704056
811,2023-03-22T00:00:00,3876,131,132,246,38274975,12691546,462333,,12229213,7704199
812,2023-03-23T00:00:00,3796,118,171,224,38278771,12691561,462277,,12229284,7704334
813,2023-03-24T00:00:00,3669,102,115,235,38282440,12691560,462264,,12229296,7704475
814,2023-03-25T00:00:00,4249,107,172,246,38286689,12691572,462197,,12229375,7704639
815,2023-03-26T00:00:00,2466,115,211,199,38289155,12691596,462099,,12229497,7704758
816,2023-03-27T00:00:00,910,48,32,67,38290065,12691572,462115,,12229457,7704761
817,2023-03-28T00:00:00,3062,88,77,199,38293127,12691574,462124,,12229450,7704884
818,2023-03-29T00:00:00,4122,126,136,220,38297249,12691630,462112,,12229518,7705041
819,2023-03-30T00:00:00,3797,112,165,210,38301046,12691693,462059,,12229634,7705208
820,2023-03-31T00:00:00,3921,143,109,212,38304967,12691788,462093,,12229695,7705374
821,2023-04-01T00:00:00,4153,140,146,223,38309120,12691917,462087,,12229830,7705586
822,2023-04-02T00:00:00,2167,64,120,169,38311287,12691976,462031,,12229945,7705750
823,2023-04-03T00:00:00,766,25,12,52,38312053,12692001,462044,,12229957,7705802
824,2023-04-04T00:00:00,3362,78,71,164,38315415,12692069,462051,,12230018,7705956
825,2023-04-05T00:00:00,4254,112,102,233,38319669,12692181,462061,,12230120,7706189
826,2023-04-06T00:00:00,3539,111,105,171,38323208,12692292,462067,,12230225,7706360
